1111111111111111111111111
0111111111111111111111110
0101111111111000000000010
0111111111111111111111110
0100000000000001111111010
0111111111111111111111110
0111111111111111111111110
0111111111111111111111110
0100111111100000000000010
0111111111111111111111110
0100000000000011100000010
0111111111111111111111110
1111111111111111111111111
