0000000000000000000000000
0000000000000000000000000
0000000000111111000000000
0000000000100010000000000
0000000000100010000000000
0000000000100010000000000
1111111111100010111111111
0000000000000010000000000
0000000000000010000000000
0000000000000010000000000
0000000000000010000000000
0000000000000010000000000
0000000000000010000000000
